Talvin Singh - OK - Mombasstic
Bacuzzi - Hi-Fidelity Dub Sessions vol.3 - Sunday's Child
deadbeat - new world observer - slow rot from rhetoric
Michael Franti & Spearhead - Recline: A Six Degrees Collection of Chilled Grooves - Skin on the Drum (Bassnectar Remix)
Lemon Jelly - Space Walk
Nitin Shawhney - Untouchable Outcaste Beats v1 - Bengali Song
Black Mighty Orchestra, Henry Mancini - Ocean Beach (Lujon)
B-Flow - At Night There's Not Nationalities
Nusrat Fateh Ali Khan - Talvin Singh - Back To Mine - Mustt, Mustt (Massive Attack Remix)
Michael Franti & Spearhead - Recline: A Six Degrees Collection of Chilled Grooves - Skin on the Drum (Bassnectar Remix)
Thievery Corporation - The Mirror Concpiracy - Lebanese Blonde
Nitin Shawhney - Untouchable Outcaste Beats v1 - Bengali Song
Fragile - Future Dub #01 - The Day He Crossed A Lower Sky
Chris Zippel - Truth Is, Alt's Camera
Banco De Gaia - Maya
Electronic Flip - M-Seven
Mindtrap - Late At Night
Massive Attack - Angel
Stargarden - Lulabeene
Bonobo - Dial M for Monkey - Noctuary
Architect - Four The Number Of The World
Kumo - Kick Your Ass
Bluetech - Condensation
David Arkenstone - Shinkansen
Great Leap Forward - In Name Of The Super Natural
Palm Skin Productions - The Beast (Autechre Mix)
Bluetech - Leaving Babylon
Optic Eye - Trance Dance [bladerunner]
Ace Ventura & Lish - The Light (Bluetech Remix)
Future Sound Of London - Among Myselves
Ram Dass & Kriece - Spacesuit For Earth
David Bickley - Buttercupped
Bluetech - Condensation
Sounds From The Ground - Dune
Astro Pilot - Yasmin
Digital Samsara - 7am
