DJ Manu/ Lexi (x.pensive) - SourceLab 1-1 - Many Are Called
Seba - External Reality
the untouchebles-tribulation
dbr uk-  tribal roots
The Invisible Man - The Bell Tune
The Blunt Needles - Notes of Despair
Sub - Crystal (NSF Destroy2k Remix)
Shogun - Slipstream (Technical Itch Remix)
Dub-One - Watcha Man
Badman - War In 94
Iaka - The One I Like
Ed Rush - The Dreadd
Hek 187 - High Rollay
Morphy - Echo Chamber
Nucleus & Paradox - Esoteric Funk
Iaka - The One I Like
Samurai - Roy Batty Is Still Alive (Alternative Ending)
Breakage - Lead Me On
Breakage - 2239375
Dom & Roland - Time
Source Direct - Dubstar
Paradox - Pride Of Sixtynine
Macc - Guttural
Microtek - Anaconda
Nucleus & Paradox - Fuzzy Something
Fluter & Dissident - The First Day Of Sorrow
Raster - Blood & Fire
Studio Pressure - Resolution
Doc Scott - Jungle Jungle
Adam F - Metropolis
Iaka - Rumpelkiste
Pariah - Living Cell
Groove Corporation - Dub Plates From The Elephant H - Red Sea
Stakka & K. Tee - Dream World
Alpha Omega - Mayhem
ASC - The Lair
