Virginia - Dj Kicks-Smith & Mighty - Rainbows
Thumbzo - The Spitfire Show-21 Today - LIVE from Ramsgate, UK
Treponem Pal - Future Dub #01 - Panorama (Jungle Mix By Dread Zone)
DJ Manu/ Lexi (x.pensive) - SourceLab 1-1 - Many Are Called
DJ Manu/ Lexi (x.pensive) - SourceLab 1-1 - Many Are Called
AMe one - Depths Of Alpha
Stakka & K.Tee - Brockin` Out
Rap - Intelligent Woman
Nucleus & Paradox - Dilettantes
Dylan - Blackout
Peshay - Futurama
Kryptic Minds & Leon Switch - Blueprint
Tuff To The Bone - Bad Boy Talk
Prinza ft Demolition Man - Fire
Ed Rush - What's Up
Lemon D - In My Life
Ed Rush - I Wanna Stay In The Jungle
Fanu - Music For The Motherless Japanese Child
Hokusai - Red Lights
Shapez - Deep Cutz Radio ft. Skitt B - LIVE from Boxmeer, The Netherlands
Breakage - 47 Kuts
Cerberus ft Sjoewe - Sub Woofing - LIVE from Utrecht, The Netherlands
Erogenous Zone - Sweetest Feeling
Ray Keith - The Dubplate (Final Plate)
Dom & Optical - Quadrant 6

Buzz - Neo`s Dream
Alpha Omega - Realism
Neo-Tech - Valves
Source Direct - Haunted
House Crew - Superhero
Alpha Proxima - Conspiracy Theory
J Majik - Your Sound
Naphta - Soundclash (Part 1: Long Time Burning Mix)
Digital - Ras 78
S.U.V. - Snake Charmer
Duo Infernale - Concrete Jungle
Boymerang - You Like It Like That
Skeptic - Absorb
